'33627','4','-75','-75'
'33627','5','-75','-75'
'33627','8','-100','-80'
'33627','12','-75','-75'
'33627','13','-75','-75'
'33627','14','-75','-75'
'33627','18','-75','-75'
'33627','21','-75','-75'
'33627','22','-75','-75'
'33627','23','-75','-75'
'33627','24','-75','-75'
'33627','29','-75','-75'
'33627','37','-75','-75'
'33627','38','-75','-75'
'33627','39','-75','-75'
